0,0,0,0,0,0,0,0,x,e
0,0,0,0,0,0,0,x,0,0
0,0,0,0,0,0,x,0,0,x
0,0,0,0,0,x,0,0,x,0
0,0,0,0,x,0,0,x,0,0
0,0,0,x,0,0,x,0,0,0
0,0,x,0,0,x,0,0,0,0
0,x,0,0,x,0,0,0,0,0
x,0,0,x,0,0,0,0,0,0
b,0,x,0,0,0,0,0,0,0